..m....p.
...###...
..#.$.#..
#..m.....
#.......#