..m.....p.
##......##
$...###...
#.m.....##
..........