..m.....p.
##......##
$...###...
#.m.....##
.......$..